file_name,width,height,avg_intensity,std_intensity,min_intensity,max_intensity,intensity_range,avg_gradient,aspect_ratio
577669.0.png,128,128,143.81243896484375,28.265167890490627,69,254,185,40.19932449442491,1.0
477859.0.png,128,128,144.66998291015625,26.06171615933283,67,254,187,68.815684250189,1.0
608201.0.png,128,128,168.663330078125,22.883849958225554,75,254,179,59.231831783616634,1.0
581072.0.png,128,128,141.056396484375,18.235559706132552,67,250,183,40.23556268945338,1.0
2273870.0.png,128,128,173.6611328125,21.670870404932074,76,252,176,57.942562354682735,1.0
616095.0.png,128,128,149.57891845703125,32.03100415152895,65,254,189,83.81639493100371,1.0
623286.0.png,128,128,166.3160400390625,26.980105998128916,67,253,186,52.91378929880615,1.0
2100956.0.png,128,128,165.18389892578125,26.00043300859267,67,251,184,72.55880886453734,1.0
2330174.0.png,128,128,161.9254150390625,14.07439786864262,76,254,178,29.52990920021243,1.0
637468.0.png,128,128,147.18634033203125,31.441639054616964,64,253,189,83.84585561362513,1.0
932857.0.png,128,128,145.886962890625,23.31860030260911,67,252,185,69.73018982848296,1.0
951070.0.png,128,128,146.26849365234375,22.320764915489733,73,248,175,33.82480651020338,1.0
456592.0.png,128,128,145.82562255859375,28.071203762780147,65,253,188,50.34297701575383,1.0
670586.0.png,128,128,136.855712890625,31.9028456279335,60,253,193,86.83681468187072,1.0
854004.0.png,128,128,157.81536865234375,33.419747852420564,68,255,187,101.68844640318707,1.0
487886.0.png,128,128,142.4296875,31.206994822938434,70,253,183,61.36458997303771,1.0
542020.0.png,128,128,147.0155029296875,27.87807847860342,67,253,186,67.41662432984734,1.0
655082.0.png,128,128,133.82354736328125,22.63580553246811,66,255,189,48.9664029521618,1.0
673165.0.png,128,128,149.58648681640625,40.55878426393089,67,255,188,120.03094557038565,1.0
519807.0.png,128,128,147.1907958984375,32.09731522692672,65,252,187,90.94128184044612,1.0
602791.0.png,128,128,149.4619140625,22.923779097133554,66,249,183,48.255695327723416,1.0
2287343.0.png,128,128,171.2156982421875,14.1122637771817,78,251,173,31.841937552113727,1.0
649256.0.png,128,128,141.64923095703125,30.0003531171337,69,253,184,53.78138342742123,1.0
541616.0.png,128,128,155.68212890625,30.11238767619579,58,255,197,74.0464186960258,1.0
621360.0.png,128,128,150.68585205078125,30.59164127103751,68,254,186,71.68933310276256,1.0
2166330.0.png,128,128,143.211181640625,20.215965490500334,70,249,179,57.533500827524314,1.0
647628.0.png,128,128,132.6988525390625,17.57711479463128,62,254,192,40.82448205866798,1.0
551297.0.png,128,128,153.68499755859375,32.11493571869348,68,254,186,77.46224165704845,1.0
633548.0.png,128,128,159.76568603515625,29.067150867663923,66,252,186,105.48036405082041,1.0
2115246.0.png,128,128,170.47796630859375,18.399474237373074,73,251,178,49.58050899103978,1.0
1048081.0.png,128,128,147.40069580078125,20.893143944158574,76,249,173,28.56205136463521,1.0
681737.0.png,128,128,157.8931884765625,15.958941382449556,72,250,178,29.756750369480667,1.0
977224.0.png,128,128,152.98779296875,32.1162834327894,61,254,193,63.76245095400036,1.0
2002867.0.png,128,128,164.1795654296875,25.198363088705012,75,252,177,66.15098490259119,1.0
2091328.0.png,128,128,172.00201416015625,23.334062023852653,76,253,177,49.30871555336002,1.0
844402.0.png,128,128,138.91693115234375,22.78858970533182,64,253,189,55.12933741027577,1.0
418831.0.png,128,128,161.2904052734375,14.983817466550695,75,247,172,21.5052737020995,1.0
2378321.0.png,128,128,173.4139404296875,20.32496110563733,56,253,197,62.183172864598035,1.0
656211.0.png,128,128,175.790283203125,30.58350726005842,72,253,181,95.72127674334315,1.0
315910.0.png,128,128,164.32366943359375,22.585561303769957,77,253,176,63.47437490500112,1.0
680908.0.png,128,128,146.06640625,28.89572205873905,66,252,186,59.87516011403866,1.0
335178.0.png,128,128,164.3114013671875,22.66290746774647,72,252,180,62.13078716872922,1.0
688841.0.png,128,128,142.63360595703125,26.857099707929805,66,254,188,69.00727080109198,1.0
2092875.0.png,128,128,168.8221435546875,28.35462439368111,74,254,180,72.37201259983722,1.0
494273.0.png,128,128,126.73980712890625,12.842461627971709,62,253,191,26.207830114547534,1.0
745330.0.png,128,128,137.49737548828125,26.040265975913403,61,254,193,49.03253719823026,1.0
930551.0.png,128,128,172.450439453125,22.2413076595879,79,255,176,48.702534795158584,1.0
554663.0.png,128,128,142.502685546875,29.342892902397814,67,254,187,87.61074547251485,1.0
393335.0.png,128,128,173.052734375,25.69599117079853,76,252,176,87.5186897001068,1.0
596386.0.png,128,128,143.43572998046875,21.407841415053724,67,254,187,39.50107715938539,1.0
659695.0.png,128,128,150.416015625,31.66460167693778,60,251,191,78.99881988106262,1.0
663291.0.png,128,128,146.77142333984375,27.606933187781845,68,253,185,76.90326322674713,1.0
561071.0.png,128,128,139.1524658203125,25.098960800702464,57,253,196,49.09801658363055,1.0
613096.0.png,128,128,166.26300048828125,20.724840808651464,68,253,185,43.48733758873176,1.0
647546.0.png,128,128,144.66827392578125,38.08380368123981,61,254,193,93.18890657626808,1.0
2067753.0.png,128,128,168.959228515625,24.315294922707587,75,253,178,54.631339167327965,1.0
1897589.0.png,128,128,168.07952880859375,28.257927380410838,74,253,179,79.85538583505233,1.0
2238021.0.png,128,128,164.089599609375,18.154973310208277,76,253,177,45.24543744837818,1.0
670435.0.png,128,128,134.748291015625,20.783834355500247,63,253,190,63.7589611220703,1.0
635425.0.png,128,128,159.55657958984375,32.79809165680433,66,254,188,56.94923205332722,1.0
739768.0.png,128,128,164.1239013671875,18.463604534232246,73,252,179,35.17366098438913,1.0
642584.0.png,128,128,142.619140625,25.039716300819727,59,251,192,69.30450336209965,1.0
900451.0.png,128,128,158.515380859375,23.51702929261001,64,254,190,46.633041082994986,1.0
632933.0.png,128,128,122.10791015625,22.316642777337794,57,254,197,66.35387496042611,1.0
2152192.0.png,128,128,168.1021728515625,27.966442121355975,78,252,174,69.17334347000175,1.0
664481.0.png,128,128,153.7149658203125,33.544550537319545,68,254,186,116.75941032059647,1.0
641590.0.png,128,128,152.0003662109375,23.67497916657509,69,252,183,66.75897321171513,1.0
701728.0.png,128,128,142.31427001953125,19.616655184418036,68,251,183,55.8365402690543,1.0
952665.0.png,128,128,160.4588623046875,31.100967159816136,71,255,184,82.65909215280557,1.0
879990.0.png,128,128,168.76788330078125,19.074170768090745,75,252,177,38.01744527442731,1.0
585460.0.png,128,128,136.456298828125,33.281133279909156,60,253,193,66.38913329356711,1.0
695984.0.png,128,128,148.007080078125,26.3302312523491,61,251,190,70.82020096050051,1.0
666733.0.png,128,128,152.54351806640625,27.62455034854226,67,252,185,81.04594548015277,1.0
650099.0.png,128,128,145.34429931640625,36.90460180316614,62,253,191,112.4620330639595,1.0
666512.0.png,128,128,134.1070556640625,22.219673284764273,65,253,188,45.97137699838101,1.0
683428.0.png,128,128,154.97705078125,31.557592992523944,70,253,183,76.52392289049075,1.0
2314845.0.png,128,128,170.66436767578125,17.074453083800613,73,249,176,41.56235502629022,1.0
694948.0.png,128,128,147.34100341796875,25.9466472644654,64,254,190,59.019293316134366,1.0
651004.0.png,128,128,137.0433349609375,32.330531372062396,57,253,196,71.24153251768169,1.0
420672.0.png,128,128,151.82354736328125,21.45631246154529,66,250,184,43.12443188454279,1.0
706971.0.png,128,128,162.78656005859375,33.424592829139385,66,254,188,112.52981815468974,1.0
637291.0.png,128,128,140.9111328125,27.5342478164612,61,253,192,62.67614689703345,1.0
2287714.0.png,128,128,161.38616943359375,25.800693078002315,73,252,179,78.66732031166958,1.0
506902.0.png,128,128,160.1810302734375,17.057435904662274,72,253,181,54.26136777628037,1.0
504136.0.png,128,128,151.3505859375,33.21642769764104,69,254,185,81.2566908732092,1.0
537045.0.png,128,128,137.1888427734375,17.319714695047892,71,254,183,42.551799094797914,1.0
2117132.0.png,128,128,165.7535400390625,24.19543080305592,75,252,177,70.83712762166995,1.0
637866.0.png,128,128,149.2916259765625,32.71677126885451,70,255,185,78.8358900739804,1.0
639816.0.png,128,128,166.7337646484375,29.093425541747457,67,254,187,91.99710810689558,1.0
946008.0.png,128,128,166.13458251953125,17.29011315849951,76,253,177,36.2342630667777,1.0
628876.0.png,128,128,162.68389892578125,38.57491784377313,64,254,190,113.13554978957933,1.0
964327.0.png,128,128,149.85089111328125,29.850680975875495,65,253,188,74.44539212988946,1.0
557827.0.png,128,128,164.9649658203125,26.434854018534953,70,255,185,84.33876427117772,1.0
643711.0.png,128,128,161.71820068359375,18.534701296043437,77,253,176,59.836412726487154,1.0
695627.0.png,128,128,164.9105224609375,18.847770524147965,78,254,176,54.482662378185275,1.0
366605.0.png,128,128,162.03790283203125,14.855664343352514,78,252,174,33.40404081785459,1.0
667274.0.png,128,128,154.2340087890625,31.102871238225603,67,253,186,66.65883176733234,1.0
696848.0.png,128,128,165.79046630859375,32.838510589871035,76,254,178,88.6414411997699,1.0
550620.0.png,128,128,156.17938232421875,32.19011081961996,61,254,193,79.47614306222987,1.0
633984.0.png,128,128,175.54693603515625,28.776416517602417,58,253,195,72.52556373382083,1.0
658928.0.png,128,128,129.56890869140625,28.512844686897232,52,246,194,58.58989168518576,1.0
657154.0.png,128,128,137.5926513671875,25.584811944737755,62,253,191,55.81388572058182,1.0
599889.0.png,128,128,148.65936279296875,25.913074323264496,71,254,183,43.48875918432772,1.0
514369.0.png,128,128,153.47705078125,28.367385846754917,73,252,179,69.17844836003043,1.0
703971.0.png,128,128,164.5927734375,28.602066098124485,72,253,181,70.655163912154,1.0
612934.0.png,128,128,168.54266357421875,25.662451407480734,70,251,181,84.10115701454586,1.0
942004.0.png,128,128,165.00518798828125,21.25248801930162,68,252,184,35.20244082809172,1.0
842563.0.png,128,128,159.56982421875,29.20815955412825,70,254,184,63.87335913024555,1.0
853734.0.png,128,128,138.0638427734375,23.056514430720654,59,253,194,47.76055124532701,1.0
673322.0.png,128,128,146.29345703125,33.447044361579955,68,254,186,76.81979189488132,1.0
715905.0.png,128,128,152.98779296875,16.746158095196808,73,254,181,20.223157543456484,1.0
904374.0.png,128,128,150.57598876953125,20.84332158770448,71,254,183,38.077426466010444,1.0
621855.0.png,128,128,142.1663818359375,30.69411091747662,58,255,197,93.06458376795119,1.0
515426.0.png,128,128,136.66229248046875,20.437348384816115,63,251,188,58.91313738906234,1.0
846314.0.png,128,128,150.485595703125,32.69057014645977,68,254,186,88.83339228712077,1.0
579433.0.png,128,128,145.0684814453125,30.430231224902364,76,254,178,44.61538614702374,1.0
892906.0.png,128,128,170.78253173828125,21.836875483800075,75,253,178,47.426246724681164,1.0
545148.0.png,128,128,142.33905029296875,23.78902475318044,67,254,187,34.47168297311234,1.0
472825.0.png,128,128,139.801025390625,27.82177397915186,69,253,184,63.97656747585229,1.0
959933.0.png,128,128,143.8843994140625,23.71941782616815,70,254,184,37.894879595314414,1.0
2289638.0.png,128,128,172.67938232421875,12.311693926236162,81,238,157,31.166935317788948,1.0
975852.0.png,128,128,169.6353759765625,18.483278272230816,74,254,180,35.29535987155751,1.0
539636.0.png,128,128,150.69598388671875,25.791445303879765,69,254,185,45.44695918018933,1.0
834845.0.png,128,128,137.262451171875,24.429153410926236,65,254,189,45.60512731199899,1.0
944897.0.png,128,128,156.99664306640625,13.49011505002934,78,249,171,27.395932983252095,1.0
492784.0.png,128,128,134.8958740234375,21.409004671473927,68,253,185,63.32332456521026,1.0
678855.0.png,128,128,127.8521728515625,20.11257678146773,58,253,195,56.3894153738202,1.0
646039.0.png,128,128,131.9664306640625,26.14821637854812,57,254,197,61.21759395331176,1.0
572194.0.png,128,128,146.7379150390625,27.982807447522585,68,254,186,58.3125296963817,1.0
495294.0.png,128,128,170.59881591796875,25.291795661778714,69,254,185,72.55892050588764,1.0
944887.0.png,128,128,144.1263427734375,20.351822620786944,64,245,181,54.78440445443236,1.0
498829.0.png,128,128,147.7396240234375,24.220928878907166,69,253,184,66.0361152923818,1.0
2335185.0.png,128,128,163.04254150390625,21.34942467310979,71,252,181,58.59382660221455,1.0
618373.0.png,128,128,149.19091796875,25.99778950446116,68,254,186,57.5401221915807,1.0
634169.0.png,128,128,145.4970703125,27.470005236730366,73,254,181,56.81630775200943,1.0
438316.0.png,128,128,162.21441650390625,19.816353126810352,74,254,180,51.17606895178612,1.0
720856.0.png,128,128,152.45263671875,24.78626807013491,75,254,179,53.426025032761494,1.0
526198.0.png,128,128,143.7952880859375,29.120013442235752,64,254,190,70.81688902909254,1.0
853093.0.png,128,128,159.5733642578125,32.92013764266848,66,254,188,111.08562637722136,1.0
901821.0.png,128,128,151.4219970703125,20.11458009840493,71,251,180,31.185086064067832,1.0
2346746.0.png,128,128,159.26708984375,21.096023047152528,74,251,177,52.17082786492146,1.0
666111.0.png,128,128,157.494873046875,30.787183725085413,70,254,184,77.02287323153847,1.0
747140.0.png,128,128,153.05084228515625,25.735241438122284,69,254,185,38.740968118461254,1.0
486131.0.png,128,128,138.027587890625,25.30133522373085,69,252,183,66.07301782162497,1.0
526861.0.png,128,128,161.79742431640625,27.521365824790525,71,254,183,75.5676853992202,1.0
641450.0.png,128,128,165.15673828125,36.5635312155039,72,254,182,145.11950558335613,1.0
690455.0.png,128,128,146.70220947265625,29.257198216199388,67,254,187,78.80433628925806,1.0
404440.0.png,128,128,150.47320556640625,34.97379236193176,74,254,180,59.96729131294187,1.0
2263442.0.png,128,128,160.45843505859375,19.160846611344144,75,247,172,43.53179534115011,1.0
675703.0.png,128,128,141.70465087890625,20.794385835498375,74,254,180,36.73497067307552,1.0
609170.0.png,128,128,161.1519775390625,29.08741956665064,66,253,187,74.90351934717675,1.0
674706.0.png,128,128,139.74017333984375,30.231460734374313,64,254,190,69.37333265190955,1.0
693542.0.png,128,128,156.5364990234375,25.746667352015688,71,255,184,58.13512569625305,1.0
821168.0.png,128,128,141.3563232421875,24.29795991462456,65,252,187,47.17405010193523,1.0
577888.0.png,128,128,144.03997802734375,28.34060244546988,66,253,187,40.57153270467468,1.0
482560.0.png,128,128,152.77447509765625,34.60845766762373,64,255,191,91.0358744980696,1.0
2276071.0.png,128,128,174.84539794921875,18.761395288900104,79,253,174,42.87491771446538,1.0
691063.0.png,128,128,168.8240966796875,23.94836344581484,72,254,182,100.41685403826028,1.0
488767.0.png,128,128,161.24462890625,21.318423742807873,73,248,175,33.492632607165724,1.0
879379.0.png,128,128,146.4482421875,26.091368844123437,71,254,183,54.439307247072755,1.0
831763.0.png,128,128,147.60882568359375,26.43464861133897,68,253,185,72.8550512749801,1.0
976705.0.png,128,128,157.6026611328125,34.61400163415536,66,254,188,78.085579633647,1.0
2091324.0.png,128,128,170.9573974609375,28.85275271651806,76,251,175,84.5837981238409,1.0
2272380.0.png,128,128,175.65240478515625,16.30434393589325,75,251,176,34.92356480180608,1.0
589109.0.png,128,128,143.6680908203125,23.960805140398072,67,253,186,80.08987487304327,1.0
525208.0.png,128,128,141.29315185546875,29.726533746329498,69,253,184,60.08869466301384,1.0
856753.0.png,128,128,152.9593505859375,26.282193947973337,72,254,182,76.85096683452176,1.0
2196645.0.png,128,128,162.32666015625,33.313086037553525,74,254,180,101.98650604572055,1.0
646677.0.png,128,128,166.5567626953125,30.45442693260367,73,254,181,123.8161687344522,1.0
2151011.0.png,128,128,167.85882568359375,28.752435426532454,75,253,178,73.22719822198917,1.0
982553.0.png,128,128,155.1678466796875,25.715183367363295,65,253,188,53.15298898450945,1.0
840751.0.png,128,128,161.3902587890625,28.31668477336501,62,254,192,74.83668460271537,1.0
556497.0.png,128,128,160.4517822265625,28.694447760374953,74,255,181,61.930150318744126,1.0
946948.0.png,128,128,134.9749755859375,24.564646529723632,65,253,188,83.4710520766233,1.0
393721.0.png,128,128,174.98583984375,22.240183813369775,77,254,177,67.14244829533413,1.0
667501.0.png,128,128,135.34490966796875,24.82916719643649,64,254,190,74.26204249866319,1.0
913347.0.png,128,128,155.4580078125,13.697518605684168,75,242,167,27.5391385377087,1.0
965779.0.png,128,128,162.12774658203125,24.35375880675939,72,251,179,27.255553772354325,1.0
2087485.0.png,128,128,171.81658935546875,26.263779692174285,79,254,175,76.50130379913396,1.0
490876.0.png,128,128,133.25579833984375,18.754473667404383,69,253,184,55.01321250592241,1.0
284224.0.png,128,128,169.0062255859375,22.638683066991877,77,251,174,58.60725372863521,1.0
765908.0.png,128,128,149.73370361328125,31.85245942911849,67,254,187,68.33024515786687,1.0
462023.0.png,128,128,146.06298828125,32.105861079864376,70,253,183,84.65026400238948,1.0
707000.0.png,128,128,162.8660888671875,27.667739270206624,67,253,186,70.02031244120786,1.0
2094775.0.png,128,128,170.69830322265625,25.205292007192092,75,254,179,58.155562054042974,1.0
2076096.0.png,128,128,161.64312744140625,17.884490566319368,78,253,175,40.40604141919315,1.0
493537.0.png,128,128,146.25347900390625,21.82177159810209,64,252,188,52.20045268228915,1.0
495762.0.png,128,128,162.5286865234375,20.585130317034928,74,250,176,51.91980064807723,1.0
402448.0.png,128,128,173.50799560546875,15.612543770454439,79,254,175,39.19447895773813,1.0
583009.0.png,128,128,126.86083984375,30.945152457578676,62,252,190,103.90276845329129,1.0
596189.0.png,128,128,167.92974853515625,17.955256721386807,78,253,175,46.83508358232008,1.0
716886.0.png,128,128,161.34869384765625,34.05322848306953,63,254,191,69.02450520152499,1.0
2387745.0.png,128,128,168.389892578125,21.16039438238683,73,252,179,58.00797042399576,1.0
605965.0.png,128,128,142.01971435546875,30.639378632166846,66,254,188,77.77242378070949,1.0
410202.0.png,128,128,159.64825439453125,21.552403504165774,73,252,179,50.39143819951272,1.0
624644.0.png,128,128,143.318115234375,31.039932602679865,63,254,191,91.08961399009479,1.0
381456.0.png,128,128,167.7437744140625,23.97181109877518,71,250,179,80.72217263558778,1.0
2099782.0.png,128,128,165.60546875,26.926240838236424,70,253,183,76.42019007760774,1.0
2052772.0.png,128,128,166.97833251953125,27.722335974227466,73,255,182,84.83993553817753,1.0
2076952.0.png,128,128,160.46514892578125,17.91921858724944,74,251,177,43.59855328063891,1.0
855447.0.png,128,128,150.1011962890625,27.246100432965953,69,254,185,79.28059740574582,1.0
718947.0.png,128,128,166.267578125,23.296032609555194,64,252,188,63.55241190577051,1.0
671466.0.png,128,128,135.61114501953125,20.326385886105857,58,253,195,42.74911008894614,1.0
2025970.0.png,128,128,163.53607177734375,16.926633033717287,76,253,177,36.26881600532342,1.0
2290006.0.png,128,128,171.6937255859375,14.553878372131281,77,252,175,34.02556574322611,1.0
633480.0.png,128,128,139.77813720703125,22.93152613043073,54,254,200,67.79266615917693,1.0
668545.0.png,128,128,134.90850830078125,24.072367414139347,71,254,183,41.793824633446505,1.0
703756.0.png,128,128,165.839599609375,27.680194070580498,77,254,177,67.27032072298206,1.0
661918.0.png,128,128,164.8831787109375,33.76114218931354,69,253,184,133.92650593595835,1.0
665777.0.png,128,128,169.4124755859375,21.352107752926127,69,253,184,81.22986758083425,1.0
656745.0.png,128,128,131.45281982421875,24.384565342870083,67,254,187,48.17994606704705,1.0
488919.0.png,128,128,167.84295654296875,26.557206420120412,74,253,179,74.9970295587545,1.0
517656.0.png,128,128,149.7786865234375,19.935521547442125,74,254,180,50.5230086920053,1.0
710417.0.png,128,128,168.68231201171875,30.19792238278377,70,255,185,102.59496789126048,1.0
2151776.0.png,128,128,168.23394775390625,27.965350131890418,75,253,178,68.8592566403039,1.0
2090957.0.png,128,128,171.696044921875,28.502452333875713,72,254,182,84.22754198671343,1.0
599009.0.png,128,128,138.3416748046875,26.907192864717267,72,253,181,40.61181180121307,1.0
871010.0.png,128,128,164.503662109375,23.787521476505386,64,255,191,52.1331868387214,1.0
643988.0.png,128,128,133.17877197265625,22.437822857525614,70,250,180,46.87978301815757,1.0
975306.0.png,128,128,148.90142822265625,31.755893244761356,67,253,186,69.5332784301995,1.0
2261907.0.png,128,128,165.09600830078125,24.107967365824308,73,251,178,48.19603581543731,1.0
2264970.0.png,128,128,164.24114990234375,23.93915502082975,71,252,181,46.54841904592955,1.0
2271635.0.png,128,128,173.84710693359375,21.641555715078308,77,254,177,57.2388724862799,1.0
646481.0.png,128,128,137.69329833984375,28.616484541425177,65,254,189,62.12032218393596,1.0
521672.0.png,128,128,131.2349853515625,18.041411014018237,64,253,189,38.51815908615771,1.0
927590.0.png,128,128,161.03851318359375,21.16359198296471,69,253,184,58.160932269717655,1.0
674088.0.png,128,128,141.09735107421875,22.174137323243652,63,251,188,46.003902488715156,1.0
491093.0.png,128,128,156.3731689453125,27.56917175517573,72,254,182,52.285526572826754,1.0
887719.0.png,128,128,149.27484130859375,26.89357255869763,64,254,190,77.01889074612106,1.0
901880.0.png,128,128,169.62213134765625,28.31827645178189,77,254,177,51.10164915130463,1.0
2340963.0.png,128,128,163.2044677734375,22.21298194644436,62,252,190,63.899016152626515,1.0
2095153.0.png,128,128,166.6129150390625,28.8064187284636,74,252,178,76.58728865014162,1.0
551299.0.png,128,128,150.7647705078125,24.34610595339258,62,253,191,47.308871389033015,1.0
648428.0.png,128,128,140.65740966796875,27.57719992303184,62,254,192,65.32768874954502,1.0
804891.0.png,128,128,143.331298828125,30.175918243986096,60,254,194,56.92703223631578,1.0
466794.0.png,128,128,143.53204345703125,29.00498885520039,66,253,187,63.93390456581519,1.0
2093650.0.png,128,128,168.23150634765625,29.57082840577794,72,254,182,83.09923755313034,1.0
558938.0.png,128,128,159.87713623046875,35.58805450895592,72,255,183,89.85113451306461,1.0
670476.0.png,128,128,147.130615234375,30.43995081592896,65,254,189,63.73297473050639,1.0
689060.0.png,128,128,136.45770263671875,15.686890488515704,66,253,187,34.17072419778374,1.0
482540.0.png,128,128,138.21661376953125,17.392113448719527,67,253,186,52.862286513785314,1.0
286306.0.png,128,128,165.4688720703125,27.845777717924417,77,253,176,77.04329914817978,1.0
2350346.0.png,128,128,130.7235107421875,20.115719763906082,69,252,183,51.30354408224174,1.0
428434.0.png,128,128,170.99493408203125,20.838948008995832,77,253,176,72.81541173317079,1.0
482541.0.png,128,128,139.07049560546875,20.7742051874528,70,254,184,53.982785816173546,1.0
848775.0.png,128,128,135.53106689453125,27.059378639356524,65,253,188,48.127692486956064,1.0
463528.0.png,128,128,134.852783203125,16.93684218244816,70,253,183,33.86377998239486,1.0
2004018.0.png,128,128,162.861328125,19.939809539864818,78,251,173,51.09379123053398,1.0
2271999.0.png,128,128,175.37249755859375,16.988082563436137,78,251,173,36.382520999923756,1.0
940345.0.png,128,128,161.78253173828125,19.991135976070463,70,254,184,31.72906996819698,1.0
895603.0.png,128,128,151.390625,33.36170220219773,67,255,188,92.67038177752899,1.0
2146507.0.png,128,128,171.10052490234375,26.224456782048698,75,253,178,55.151561644155365,1.0
536270.0.png,128,128,153.1181640625,28.582549072346286,68,253,185,77.39301648892499,1.0
2066097.0.png,128,128,169.01043701171875,24.63449513469766,65,251,186,57.16667475888248,1.0
2087895.0.png,128,128,171.2998046875,26.922842317229723,73,253,180,79.07243732393785,1.0
2093269.0.png,128,128,169.05157470703125,29.724154406581754,76,253,177,84.93663616516156,1.0
2120674.0.png,128,128,164.12359619140625,21.48516861845634,76,254,178,57.90690480991737,1.0
706912.0.png,128,128,160.51361083984375,28.076930454189856,69,252,183,73.44374455251979,1.0
2145744.0.png,128,128,171.68060302734375,25.166236366588752,73,253,180,49.716883894160375,1.0
639496.0.png,128,128,137.12078857421875,23.139071362075974,66,253,187,41.393923869999014,1.0
950064.0.png,128,128,165.7432861328125,31.883979530867357,70,254,184,82.94959294014723,1.0
460651.0.png,128,128,141.5020751953125,22.918056208611244,65,254,189,50.613913924067866,1.0
485144.0.png,128,128,148.57684326171875,32.671805182790116,69,254,185,83.19606389970232,1.0
721529.0.png,128,128,140.6356201171875,18.793635183081307,69,253,184,28.977561849032526,1.0
2010982.0.png,128,128,163.54547119140625,25.189695502708833,70,252,182,58.4609213418733,1.0
973680.0.png,128,128,153.1258544921875,25.564821305480923,73,254,181,59.98466778035583,1.0
666725.0.png,128,128,148.68865966796875,42.569407689163874,60,255,195,121.82705261404084,1.0
1907353.0.png,128,128,160.094482421875,30.64534534372258,69,253,184,80.35115302727553,1.0
651539.0.png,128,128,131.5919189453125,25.05162098534604,56,253,197,57.004488482797356,1.0
661671.0.png,128,128,128.8670654296875,21.040486091402826,65,249,184,40.46822587099093,1.0
508413.0.png,128,128,142.8065185546875,26.71237207299751,73,254,181,53.71008979669704,1.0
643027.0.png,128,128,140.146484375,30.654709399103847,57,250,193,90.70958522153086,1.0
659109.0.png,128,128,141.61370849609375,26.16477534425656,70,253,183,55.140563573471965,1.0
715839.0.png,128,128,162.314453125,39.10745065049134,63,254,191,109.03318482068237,1.0
486719.0.png,128,128,172.13739013671875,25.171324257342942,72,252,180,79.71130244722316,1.0
2090596.0.png,128,128,171.87158203125,28.28827801206362,77,252,175,84.03730611639155,1.0
412667.0.png,128,128,169.13018798828125,18.553993916347594,75,251,176,51.04599552586954,1.0
638014.0.png,128,128,168.16961669921875,26.132058840020907,59,254,195,80.51321188893786,1.0
498694.0.png,128,128,137.47564697265625,32.86783492939083,62,254,192,81.30018463848847,1.0
2093999.0.png,128,128,169.01763916015625,29.58279015792793,75,253,178,86.09938460041656,1.0
716676.0.png,128,128,166.10235595703125,16.829531026343364,72,255,183,36.81428713046547,1.0
2332445.0.png,128,128,137.5272216796875,21.720056529849145,67,246,179,50.94322863161828,1.0
697990.0.png,128,128,154.234619140625,29.53389344570027,64,253,189,78.82270011123538,1.0
671180.0.png,128,128,138.804443359375,16.500483532886467,62,253,191,24.890854621876816,1.0
620290.0.png,128,128,136.92230224609375,29.54189838893769,62,253,191,92.43537794213972,1.0
2258000.0.png,128,128,166.54193115234375,13.549580705183303,75,253,178,28.099766070693185,1.0
878868.0.png,128,128,167.56317138671875,23.82305096797585,71,252,181,56.86196869603898,1.0
2013336.0.png,128,128,164.87042236328125,28.517694602419102,73,252,179,79.34431702160873,1.0
1019380.0.png,128,128,167.81231689453125,19.756846918209845,76,250,174,54.73254364211413,1.0
583464.0.png,128,128,144.77398681640625,22.310888850571608,65,253,188,65.28740502919281,1.0
622090.0.png,128,128,141.46307373046875,36.537581368652894,65,254,189,121.6091179487468,1.0
2236139.0.png,128,128,163.822998046875,17.98028619886138,77,251,174,43.65085541503878,1.0
499833.0.png,128,128,159.79522705078125,22.939684504547454,66,253,187,67.53282755500565,1.0
954185.0.png,128,128,145.8143310546875,16.541767675311988,70,241,171,26.636890194477264,1.0
626949.0.png,128,128,165.067138671875,35.937087419048915,64,254,190,115.23984389996805,1.0
504712.0.png,128,128,136.2440185546875,28.784414284925415,60,254,194,53.67367678955063,1.0
2327780.0.png,128,128,140.7586669921875,19.131065484767575,68,250,182,37.926196613211665,1.0
702695.0.png,128,128,163.7008056640625,31.98939276308485,67,254,187,68.52920624904158,1.0
472380.0.png,128,128,140.7891845703125,21.6511930472718,66,254,188,43.55339776589198,1.0
644735.0.png,128,128,166.07025146484375,29.716117108418093,75,254,179,85.525897717604,1.0
2314095.0.png,128,128,161.401611328125,21.632426523310652,71,252,181,58.94919128274218,1.0
612551.0.png,128,128,149.2110595703125,33.92109963920361,68,254,186,72.19955295014987,1.0
480092.0.png,128,128,141.7252197265625,25.963643332517965,67,254,187,56.72000664061157,1.0
479695.0.png,128,128,148.4635009765625,30.949453354437065,66,251,185,83.63148031034504,1.0
480645.0.png,128,128,161.6685791015625,22.340895775578616,77,250,173,60.632033910444704,1.0
610628.0.png,128,128,136.662353515625,24.012890392617027,57,254,197,50.60850459165206,1.0
713159.0.png,128,128,154.69793701171875,42.57391614108138,60,254,194,115.34137803587603,1.0
2073353.0.png,128,128,161.587890625,18.359533638776057,72,251,179,41.0542652674957,1.0
617321.0.png,128,128,133.341064453125,22.85543921688286,72,251,179,33.547864928634304,1.0
672818.0.png,128,128,163.7579345703125,30.7661665618856,67,254,187,98.39812665861811,1.0
505395.0.png,128,128,134.51263427734375,29.010775317382695,57,252,195,51.1034236011629,1.0
633623.0.png,128,128,141.0469970703125,22.721401222238573,64,252,188,61.92333916880523,1.0
492189.0.png,128,128,137.833251953125,19.3068364412742,66,253,187,67.28569626283848,1.0
710427.0.png,128,128,165.40301513671875,21.843721906070215,73,252,179,64.84175624331249,1.0
723160.0.png,128,128,141.24407958984375,21.766543251841586,67,252,185,42.549437080394824,1.0
854549.0.png,128,128,149.5623779296875,22.790896033322174,62,253,191,54.33504953295767,1.0
584773.0.png,128,128,171.76953125,33.10618177698216,67,254,187,89.89121587123418,1.0
312808.0.png,128,128,167.95672607421875,22.207523313571375,77,253,176,69.67997681287986,1.0
440767.0.png,128,128,170.30322265625,17.78035680877353,70,253,183,45.236176514599435,1.0
986325.0.png,128,128,158.72113037109375,30.96723323088725,72,254,182,69.36442798599433,1.0
664472.0.png,128,128,147.62432861328125,35.26413372474726,66,254,188,65.48065124890084,1.0
616172.0.png,128,128,159.37872314453125,21.149949761929463,72,252,180,42.98188797327662,1.0
2371854.0.png,128,128,174.96453857421875,16.049298435765046,72,248,176,41.404838623518884,1.0
639315.0.png,128,128,140.8746337890625,27.706403696151053,66,254,188,45.487171346582464,1.0
2096697.0.png,128,128,166.84130859375,27.87651888810424,73,253,180,83.07191566734586,1.0
987889.0.png,128,128,155.001953125,25.48997382730223,68,252,184,46.608929625753845,1.0
482771.0.png,128,128,135.33636474609375,22.34705407973815,66,253,187,42.15464787445434,1.0
855892.0.png,128,128,145.0595703125,24.919822431363375,67,254,187,59.106145538741316,1.0
2109055.0.png,128,128,165.8082275390625,22.192406272749885,55,252,197,64.32991240757184,1.0
915394.0.png,128,128,149.20556640625,31.591199487052506,56,251,195,85.8831022779691,1.0
912805.0.png,128,128,166.55670166015625,22.79398773182548,71,251,180,34.93804615530997,1.0
918116.0.png,128,128,142.25982666015625,26.802282751887773,60,254,194,68.90632304875072,1.0
593655.0.png,128,128,143.569091796875,18.748609629579324,70,253,183,32.55028622902654,1.0
676674.0.png,128,128,150.7515869140625,32.475699823478365,68,254,186,71.56757978259296,1.0
872579.0.png,128,128,157.50921630859375,26.056446258501097,73,254,181,49.83219041646231,1.0
943277.0.png,128,128,141.15899658203125,23.60512300123235,67,251,184,56.64185406298684,1.0
867705.0.png,128,128,139.52520751953125,19.55247844671064,70,254,184,43.22290503899666,1.0
2291513.0.png,128,128,163.28131103515625,23.395293295422544,72,253,181,58.39491399638675,1.0
596256.0.png,128,128,165.12310791015625,22.13843150763482,77,253,176,46.553490166633225,1.0
557820.0.png,128,128,172.4830322265625,23.39552136846873,74,252,178,48.650578691616374,1.0
582870.0.png,128,128,167.75384521484375,33.273572560912,71,255,184,81.27151100121856,1.0
619560.0.png,128,128,170.0928955078125,29.214160958390593,62,254,192,89.64891925336839,1.0
679870.0.png,128,128,158.9503173828125,27.0454144138565,70,255,185,68.30767005380011,1.0
679015.0.png,128,128,168.39288330078125,25.411779661094155,64,253,189,109.20028520990377,1.0
539262.0.png,128,128,181.6986083984375,28.12185282768336,71,253,182,82.00084133337046,1.0
2308436.0.png,128,128,164.61651611328125,13.996092268916826,77,252,175,35.059970714291225,1.0
2076953.0.png,128,128,162.005615234375,18.262345800395014,74,251,177,42.60251315055851,1.0
613387.0.png,128,128,160.81158447265625,26.78076611434197,69,253,184,45.364459510094576,1.0
642736.0.png,128,128,166.92919921875,27.559601019302228,67,253,186,109.84521469626173,1.0
545731.0.png,128,128,149.5028076171875,27.665850503996317,72,254,182,77.98535479155915,1.0
624332.0.png,128,128,152.92572021484375,38.55664857086808,58,254,196,135.0928682252211,1.0
992437.0.png,128,128,146.71533203125,21.603547756583993,69,252,183,47.60477181567648,1.0
540634.0.png,128,128,130.8321533203125,20.757261797642478,62,254,192,46.22833706323415,1.0
878983.0.png,128,128,131.37176513671875,15.038343283435987,65,252,187,49.40195568769115,1.0
2293421.0.png,128,128,161.98553466796875,20.489879915162096,73,245,172,38.865505655492456,1.0
967859.0.png,128,128,162.3385009765625,29.998822683588205,74,254,180,71.62418337021376,1.0
656930.0.png,128,128,134.21783447265625,23.92405325235314,63,253,190,36.41273484656127,1.0
2321184.0.png,128,128,138.38427734375,21.203856998815226,66,245,179,47.38968092570826,1.0
994001.0.png,128,128,150.09613037109375,26.591917986739357,57,253,196,54.74475856142899,1.0
613623.0.png,128,128,145.68463134765625,23.82471990292777,68,254,186,67.61522433367489,1.0
2094342.0.png,128,128,168.31768798828125,29.56815798171989,75,252,177,85.90642217998413,1.0
966293.0.png,128,128,156.34326171875,30.32528070617098,65,254,189,76.69793775099292,1.0
890804.0.png,128,128,148.65673828125,21.41429692515472,72,252,180,45.17326067131345,1.0
2053530.0.png,128,128,167.77313232421875,27.604658947512227,76,253,177,84.06740241013983,1.0
527083.0.png,128,128,168.1192626953125,28.84175761745796,72,253,181,93.84125889244352,1.0
651857.0.png,128,128,165.613525390625,26.34547699101538,61,254,193,69.58233100308203,1.0
2301240.0.png,128,128,162.2928466796875,16.18216558467055,69,250,181,40.54188537832503,1.0
519304.0.png,128,128,152.72344970703125,19.503520863880006,76,253,177,37.50504283491071,1.0
604188.0.png,128,128,157.34954833984375,34.56867416373647,73,255,182,77.237569656437,1.0
2264181.0.png,128,128,164.465087890625,24.237349247131615,71,252,181,48.00140321306628,1.0
648229.0.png,128,128,139.83392333984375,32.22867427305101,61,255,194,82.04095091322856,1.0
551611.0.png,128,128,142.21685791015625,30.135064311608353,70,254,184,65.84322198163969,1.0
643448.0.png,128,128,159.2589111328125,32.58523200635709,73,253,180,124.0577007526728,1.0
2158587.0.png,128,128,161.46246337890625,16.22218720159644,74,253,179,36.79347684537536,1.0
605175.0.png,128,128,155.88800048828125,34.6113232035752,66,255,189,84.05973234858635,1.0
2089037.0.png,128,128,171.94854736328125,27.453789327285147,74,252,178,81.67880781401198,1.0
913678.0.png,128,128,166.818603515625,27.053433014935116,66,253,187,80.34842196532304,1.0
615725.0.png,128,128,168.57550048828125,22.238268015398745,70,253,183,44.490281788461125,1.0
2284600.0.png,128,128,161.63421630859375,26.33005238950485,73,251,178,78.05673400838558,1.0
516780.0.png,128,128,157.697998046875,23.45371014210084,64,254,190,79.99792227543931,1.0
2007493.0.png,128,128,164.92327880859375,20.86445479091343,78,252,174,50.65626718145268,1.0
613095.0.png,128,128,152.7452392578125,30.575628479643353,68,254,186,76.50857810788847,1.0
657321.0.png,128,128,138.5225830078125,23.855153272699972,60,251,191,50.54770272396867,1.0
2309591.0.png,128,128,175.56048583984375,16.385120431089405,75,250,175,50.906321631273684,1.0
690689.0.png,128,128,147.79095458984375,28.581026262601625,70,254,184,68.00389727048403,1.0
2121481.0.png,128,128,175.342041015625,14.721804192619114,80,245,165,44.70576692444955,1.0
882036.0.png,128,128,145.78424072265625,30.02091382323157,67,254,187,46.03076628524606,1.0
660423.0.png,128,128,159.78717041015625,29.47114094143465,75,252,177,102.1854015985804,1.0
2112661.0.png,128,128,164.8349609375,23.731363131776146,76,254,178,71.76785950922581,1.0
2237266.0.png,128,128,163.619873046875,16.377296940032807,75,251,176,37.4938669922353,1.0
471046.0.png,128,128,148.83758544921875,17.828188018348943,72,253,181,39.585132237541664,1.0
710412.0.png,128,128,160.2841796875,20.879269625835512,75,253,178,37.83204647734139,1.0
671012.0.png,128,128,160.01983642578125,28.713052168256052,66,254,188,81.48972553127192,1.0
615724.0.png,128,128,165.151123046875,27.840895594229107,72,253,181,88.9399106233801,1.0
701467.0.png,128,128,158.955322265625,23.00562953340282,71,254,183,60.64584445588404,1.0
2001729.0.png,128,128,163.98876953125,25.215041855817613,72,251,179,66.34259651947119,1.0
637467.0.png,128,128,141.8521728515625,27.093720672298957,65,252,187,45.51458557083679,1.0
890317.0.png,128,128,173.6209716796875,23.258386206670725,70,254,184,53.48587633633694,1.0
513718.0.png,128,128,146.37261962890625,28.12558610192857,68,254,186,84.64012883211154,1.0
467781.0.png,128,128,136.6221923828125,26.616305077427775,63,253,190,62.26585464725373,1.0
954303.0.png,128,128,132.7957763671875,18.019342275125176,70,250,180,35.627001801309845,1.0
777065.0.png,128,128,131.8974609375,24.47842856951502,57,253,196,82.38704887390398,1.0
688245.0.png,128,128,169.5362548828125,24.280664890743772,72,252,180,74.07689117138841,1.0
497344.0.png,128,128,136.710693359375,22.156284002700346,67,254,187,48.595822882419284,1.0
992968.0.png,128,128,154.689453125,18.420791451746588,75,251,176,33.69440208395787,1.0
913461.0.png,128,128,161.4237060546875,20.318203274700096,73,251,178,54.937415037608076,1.0
487916.0.png,128,128,170.0185546875,24.266857914205936,74,253,179,71.97660690337327,1.0
719023.0.png,128,128,161.146484375,39.873073184537,64,253,189,182.17359478364583,1.0
485617.0.png,128,128,144.22662353515625,22.3399903234585,72,252,180,49.62839596379618,1.0
690067.0.png,128,128,164.61376953125,36.59223711712563,69,253,184,107.81145386262506,1.0
646911.0.png,128,128,141.97137451171875,28.578500431776977,68,254,186,77.26387135635693,1.0
2273108.0.png,128,128,173.80889892578125,21.718188873339006,77,251,174,57.01975692850841,1.0
480813.0.png,128,128,171.05865478515625,25.244160052279113,74,250,176,74.38460212319367,1.0
942048.0.png,128,128,144.30633544921875,24.04721701955386,71,255,184,55.32016294590637,1.0
507578.0.png,128,128,135.047119140625,24.943360673747417,60,252,192,40.673261804476546,1.0
611664.0.png,128,128,161.98590087890625,30.01443108218846,66,254,188,71.6997549476298,1.0
625980.0.png,128,128,142.09539794921875,25.259244098248043,67,252,185,40.93734971597264,1.0
549178.0.png,128,128,149.7998046875,26.585267539695092,70,253,183,74.88307914623945,1.0
625997.0.png,128,128,151.4635009765625,37.47181409292907,62,253,191,131.40088520824048,1.0
583287.0.png,128,128,164.64959716796875,31.297484760407837,66,255,189,74.19485861983058,1.0
2375239.0.png,128,128,169.99224853515625,21.12609790445692,76,252,176,59.70303325745564,1.0
968811.0.png,128,128,168.70367431640625,16.05255714805546,63,252,189,31.9940286374757,1.0
707299.0.png,128,128,166.051513671875,30.35145141797254,57,255,198,101.12490454070047,1.0
492678.0.png,128,128,170.33184814453125,23.99757467303472,78,254,176,62.71410601601718,1.0
915839.0.png,128,128,174.7403564453125,20.712933225466504,77,255,178,36.531187094307576,1.0
545345.0.png,128,128,135.90777587890625,25.841919204434483,52,254,202,70.98930238130684,1.0
590608.0.png,128,128,140.09088134765625,19.07686714871062,61,254,193,37.99376951754846,1.0
701112.0.png,128,128,160.47369384765625,30.713572353869043,73,254,181,87.04410139819691,1.0
569952.0.png,128,128,136.59906005859375,23.500331438722124,66,254,188,56.77229478465801,1.0
645487.0.png,128,128,164.29266357421875,24.03286232572978,71,254,183,63.37347427857297,1.0
662874.0.png,128,128,142.4388427734375,23.515257368984432,67,254,187,45.9562096258455,1.0
611593.0.png,128,128,156.17724609375,27.63170617897695,70,253,183,40.353779107635305,1.0
692075.0.png,128,128,163.63525390625,39.165349193829414,70,255,185,115.04301728919654,1.0
563951.0.png,128,128,129.2891845703125,24.622109606286394,61,253,192,39.3401773162358,1.0
2092882.0.png,128,128,171.58160400390625,24.248523653622637,77,254,177,52.904160581031576,1.0
2065307.0.png,128,128,168.73699951171875,23.915137914421905,77,252,175,52.42330057679856,1.0
785217.0.png,128,128,141.32513427734375,29.163798813543693,60,255,195,72.64905380525042,1.0
642442.0.png,128,128,136.611572265625,27.428602769221236,66,255,189,44.812003281272965,1.0
2277618.0.png,128,128,173.20440673828125,21.931420601150396,77,253,176,63.639761914486925,1.0
579727.0.png,128,128,146.5184326171875,29.1020841326463,67,251,184,46.050681021771,1.0
494132.0.png,128,128,163.102783203125,24.120411380892072,66,253,187,60.35199355571817,1.0
706873.0.png,128,128,162.58758544921875,29.18325918870308,69,254,185,72.74714337421,1.0
2324262.0.png,128,128,141.09234619140625,20.116235232638314,71,254,183,44.41935979135417,1.0
618920.0.png,128,128,146.54840087890625,29.87900774195796,71,253,182,83.56105996179122,1.0
1984867.0.png,128,128,143.5096435546875,22.499108158754936,68,252,184,55.629452811202555,1.0
729880.0.png,128,128,162.3968505859375,24.046361874056252,69,251,182,53.96479264647127,1.0
561925.0.png,128,128,140.73675537109375,16.499869839085346,63,255,192,32.900291999116774,1.0
498156.0.png,128,128,132.72418212890625,26.174543449599156,63,253,190,54.501632771106564,1.0
755383.0.png,128,128,138.35870361328125,27.317032593349158,70,254,184,55.758030284069406,1.0
657955.0.png,128,128,149.1866455078125,28.981967173863705,65,252,187,77.89513387281409,1.0
610560.0.png,128,128,150.20025634765625,23.059289504531947,70,250,180,75.40398147773686,1.0
883304.0.png,128,128,139.991455078125,25.6349147212461,63,253,190,48.88701916444074,1.0
2117932.0.png,128,128,163.4888916015625,17.002635039404087,71,239,168,34.75227976562585,1.0
881441.0.png,128,128,158.441162109375,32.92041895832568,65,254,189,76.44136588001184,1.0
796451.0.png,128,128,137.53594970703125,26.005524063885243,65,253,188,61.127076724671426,1.0
642858.0.png,128,128,135.9979248046875,23.386162433152954,66,248,182,40.29065289896997,1.0
685936.0.png,128,128,160.128662109375,29.56805616006992,72,253,181,74.6977076732499,1.0
1029040.0.png,128,128,162.2393798828125,19.72756827896921,78,249,171,70.17424351108464,1.0
524508.0.png,128,128,141.91424560546875,29.058881784048182,66,254,188,91.48081843030127,1.0
635496.0.png,128,128,138.858154296875,25.019148368198756,66,253,187,74.47454975358578,1.0
586369.0.png,128,128,166.76318359375,23.87002099631944,74,252,178,69.33810129123586,1.0
632932.0.png,128,128,158.22735595703125,30.76966003553494,66,252,186,116.46195527780992,1.0
636534.0.png,128,128,146.94610595703125,35.81484112688274,69,254,185,75.1383188785961,1.0
679319.0.png,128,128,146.82879638671875,31.573790112016063,74,251,177,44.92575995746415,1.0
671125.0.png,128,128,125.80841064453125,14.677102372274128,62,253,191,22.317056747162066,1.0
433492.0.png,128,128,151.92230224609375,24.330234949295992,75,254,179,48.49181805676034,1.0
2212608.0.png,128,128,147.08251953125,19.587781365131995,72,251,179,32.94283847501413,1.0
565196.0.png,128,128,168.18634033203125,20.862780771482495,71,254,183,40.11608428267327,1.0
587593.0.png,128,128,157.29705810546875,29.88142584425786,63,255,192,79.29047242136286,1.0
687181.0.png,128,128,149.52874755859375,31.432054134171693,63,255,192,92.57196608274862,1.0
854765.0.png,128,128,141.4713134765625,19.35223984062305,69,252,183,33.954270881114994,1.0
756105.0.png,128,128,150.2193603515625,22.740951071701847,69,253,184,27.632634022944625,1.0
598079.0.png,128,128,164.61199951171875,29.06530824899978,74,254,180,94.36607068384632,1.0
784040.0.png,128,128,136.34259033203125,23.843348160300494,69,253,184,43.635063680497396,1.0
643570.0.png,128,128,143.791748046875,22.1705032889413,69,251,182,53.44700049040361,1.0
723696.0.png,128,128,144.7777099609375,28.510646418642388,64,253,189,57.27322373939193,1.0
2195889.0.png,128,128,162.74530029296875,31.524184023574772,71,254,183,98.73115573732491,1.0
512894.0.png,128,128,144.94122314453125,31.237804649562523,68,254,186,101.3608224223054,1.0
656335.0.png,128,128,142.46405029296875,35.53657201788921,70,252,182,50.9899428733916,1.0
640048.0.png,128,128,142.29742431640625,32.67170841072179,70,254,184,59.44198708888426,1.0
637159.0.png,128,128,147.7783203125,36.275294969280914,64,254,190,67.83402844519156,1.0
2216121.0.png,128,128,146.02587890625,19.52843890292658,74,251,177,34.10652391212505,1.0
587314.0.png,128,128,157.1124267578125,30.10064387336781,65,254,189,80.50189885690989,1.0
355925.0.png,128,128,174.10113525390625,19.22704886067766,79,252,173,47.5034999695029,1.0
536784.0.png,128,128,154.2462158203125,30.069802790826593,70,255,185,84.64193061835573,1.0
725556.0.png,128,128,141.829833984375,24.76205067999597,54,253,199,47.96730521945081,1.0
2092454.0.png,128,128,170.04083251953125,29.7081298418706,71,251,180,87.5826012358216,1.0
676680.0.png,128,128,137.52740478515625,18.711457285400716,62,253,191,23.140833459808782,1.0
463254.0.png,128,128,148.01336669921875,32.84794037765546,67,253,186,83.94010408549886,1.0
955260.0.png,128,128,142.8363037109375,25.7757912859251,73,254,181,51.928327187004186,1.0
2109056.0.png,128,128,167.33319091796875,21.810253106061477,73,252,179,61.41761941506664,1.0
307899.0.png,128,128,169.00128173828125,18.6604321845497,75,251,176,46.167001764852166,1.0
442032.0.png,128,128,138.3778076171875,22.95644250783062,69,250,181,51.18307330976248,1.0
2307332.0.png,128,128,164.5123291015625,14.140796592366788,80,251,171,35.259657939366626,1.0
655370.0.png,128,128,147.79144287109375,35.10349371521055,64,254,190,68.71660308043275,1.0
565243.0.png,128,128,139.30084228515625,18.502989076344008,65,253,188,39.787486980185534,1.0
2091329.0.png,128,128,172.07586669921875,22.78085173275422,75,252,177,45.88065861017416,1.0
940509.0.png,128,128,146.221923828125,30.492858135560986,71,253,182,73.2001114386922,1.0
506352.0.png,128,128,142.18914794921875,31.32716725323086,56,253,197,68.41934058359611,1.0
874282.0.png,128,128,144.65533447265625,29.706945393292155,69,253,184,70.05943293088211,1.0
